
  SSSSSSSSSSSSSSSSSSSSSSSSSSSSSSSSSSSSSSSSSSSSSSSSSSSSSSSSSSSSSSSSSSSSSSSSSSSSSSSSSSSSSSSSSSSSSSSSSSSSSSSSSSSSSSSSSSSSSSSSSSSSSSSSSSSSSSSSSSSSSSSSSSSSSSSSSSSSSSS
  SSSSSSSSSSSSSSSSSSSSSS             SSSSSSSSSSSSSSSSSSSSSSSSSSSSSSSSSSS        S       S        SSSSSSS                   SSSSS             SS                 S
  SSSSSSSSSSSSSSSSSSSSSS             SSSSSSSSSSSSSSSSSSSSSSSSSSSSSSSSSSS        4       4        SSSSSSS                   SSSSS             SS                 S
                       S             SSSSSSSSSSSSSSSSSSSSSSSSSSSSSSSSSSS                                                                     SS                 S
                       4      L      4           4          4      4                                                                                            S
SSS                                                                                                                                                             S
SSSS                                                                                                                                         X                  S
SSSSS                              SSSSSSSSSSSSSSSSSSSSSSSSSSSSSSSSSSSSS    4       4       4                                               5SSS                S
SSSSSSSSSSSSS  SSSSSSSSSSS   SSS   SSSSSSSSSSSSSSSSSSSSSSSSSSSSSSSSSSSSSSSSSSSSSSSSSSSSSSSSSSSSSSSSSSSSS            SSSS   SSSSS-------------SSS                S
SSSSSSSSSSSSS  SSSSSSSSSSS   SSS   SSSSSSSSSSSSSSSSSSSSSSSSSSSSSSSSSSSSSSSSSSSSSSSSSSSSSSSSSSSSSSSSSSSSS            SSSS   SSSSS             SSS                S
SSSSSSSSSSSSSTTSSSSSSSSSSS   SSS   SSSSSSSSSSSSSSSSSSSSSSSSSSSSSSSSSSSSSSSSSSSSSSSSSSSSSSSSSSSSSSSSSSSSS            SSSS   SSSSS             SSS          w     S
SSSSSSSSSSSSSttSSSSSSSSSSSTTTSSSTTTSSSSSSSSSSSSSSSSSSSSSSSSSSSSSSSSSSSSSSSSSSSSSSSSSSSSSSSSSSSSSSSSSSSSSSSSSSSSSSSSSSSSSSSSSSSSSTTTTTTTTTTTTTSSSSSSSSSSSSSSSSSSSS
SSSSSSSSSSSSSttSSSSSSSSSSStttSSStttSSSSSSSSSSSSSSSSSSSSSSSSSSSSSSSSSSSSSSSSSSSSSSSSSSSSSSSSSSSSSSSSSSSSSSSSSSSSSSSSSSSSSSSSSSSSStttttttttttttSSSSSSSSSSSSSSSSSSSS