
  SSSSSSSSSSSSSS                  SSSSSSSSSSSSSSSSSSSSSSSSSSSSSSSSSSSSSSSSSSSSSSSSS          SSSSSS                SSSSSSSSSSSSSSSSSSSSSSSSSSSSSSSSSSSSSSSSSSSSSSSSSSSSSSSSS
  SSSSSSSSSSSSSS       L          SSSSSSSSSSSSSSSSSSSSSSSSSSSSSSSSSSSSSSSSSSSSSSSSS          SSSSSS                SSSSSSSSSSSSS              SS                           S
  SSSSSSSSSSSSSS                  SSSSSSSSSSSSSSSSSSSSSSSSSSSSSSSSSSSSSSSSSSSSSSSSS          SSSSSS                SSSSSSSSSSSSS              SS                           S
                                  SSSSSSSSSSSSSSSSSSSSS4SSSSSSSSSSSSSSSSSSSSSSSSSSS                                             rrrrrr                                     S
                      S4S                                                         4                                                                                        S
SSS                                                                                                                                                                        S
SSSS                                                                                                                                         X                             S
SSSSS             SS       SS        SSSSSSSSSSSS4SSSSSSSSSSS4SSSSSSSSSSS4                                                                  5SS                            S
SSSSSSSSSSSSSSSS                SS                                              SSSS        4SSSSSS         S  SS  SSSSS  SS  SS-------------SS                            S
SSSSSSSSSSSSSSSS                SS                                              SSSS        SSSSSSS    4    S  SS  SSSSS  SS  SS             SS                            S
SSSSSSSSSSSSSSSS                SS                                              SSSS        SSSSSSS         S  SS  SSSSS  SS  SS             SS                  w         S
SSSSSSSSSSSSSSSSTTTTTTTTTTTTTTTTSSSSSSSSSSS4SSSSSSSSSSS4SSSSSSSSSSS4SSSSSSSSSSSSSSSS        SSSSSSSSSSSSSSSSSTTSSTTSSSSSSSSSSSSSTTTTTTTTTTTTTSSSSSSSSSSSSSSSSSSSSSSSSSSSSSSS
SSSSSSSSSSSSSSSSttttttttttttttttSSSSSSSSSSSSSSSSSSSSSSSSSSSSSSSSSSSSSSSSSSSSSSSSSSSS        SSSSSSSSSSSSSSSSSttSSttSSSSSSSSSSSSStttttttttttttSSSSSSSSSSSSSSSSSSSSSSSSSSSSSSS